11111
1P0E1
10001
1C001
1CCCC
