11111
1PC01
11001
1E0C1
11111
