11111
1P001
11001
1E0C1
11111
